1111111111111111111111
1000000000000000000001
10000000000E0000000001
10000000000G0000000001
10000000000C0000000001
10000000000P0000000001
1000000000000000000001
1000000000000000000001
1000000000000000000001
1111111111111111111111