111111
1EP001
100001
100001
100001
1000C1
111111